0000000000000000
0000000000000000
0000000000100000
0000000000100000
0000000000111111
0000000000100000
0000000000100000
0000000000000011
0000000000000010